#############
#          S#
#           #
#           #
#           #
#           #
#           #
#           #
#           #
#           #
#E          #
#############
