#############
#           #
#     #     #
#S    #     #
########### #
#E    #     #
#     #     #
#           #
#############
