#############
#     +     #
#     #     #
#S    #     #
#######+###+#
#E    #     #
#     +     #
#     #     #
#############
