#############
#           #
#     #     #
#E    #    S#
#############
