#############
#          S#
##########  #
#           #
# # #########
#          E#
#############
